XXXXXXX
X_E_o_X
X__X__X
X_o__SX
XXXXXXX